NO ./textures/redbrick.xpm
SO ./textures/redbrick.xpm
WE ./textures/redbrick.xpm
EA ./textures/redbrick.xpm
F 220,100,0
C 225,30,0

        1111111111111111111111111
        1000000000110000000000011
        1011000001110000001000001
        1001000000000000010000001
111111111011000001110000000000001
100000000011000001110111111111111
11110111111111011100000010001    
11111111111111011101010010001    
10000001110101011100010010101    
1000W001100000001100000010001    
10000001100000001101010010001    
1000000111010101111101111000111  
11110111 1110101 101111010001
11111111 1111111 111111111111