   F   56 , 1 ,      00254
C 112,112,112
    NO     ./textures/redbrick.xpm
SO ./textures/greystone.xpm
WE ./textures/mossy.xpm
EA ./textures/bluestone.xpm  




        1111111111111111111111111
        10000000001000000N0000011
        1011000001110000001000001
        1000000000000000010000001
111111111011000001110000000000001
100000000011000001110111111111111
11110111111111111100000010001    
1111011111111    100000010001
1111011111111    100000010001
1111011111111    100000010001
11110111111111111100000010001
11110111111111011101010010001    
11000000110101011100010010101    
10001000000000000000000010001    
10000000000000001101010010001    
1100000111010101111101111000111  
11110111 1110101 101111010001
11111111 1111111 111111111111