1111111111111111
1010000000000001
1010000000010001
1010000000000001
1010000000000011
1000000100000011
1010000000000011
1010000000100011
1010000000000011
1010000100000011
1000000000000011
1010000000000011
1010000000000011
1010000000000011
1111111111111111


